##############
#     #      #
#  P  #   D  #
#     #      #
#     #      #
#1          1#
#     #      #
#     #      #
#     #      #
#  k  #   k  #
##############