##############
#     D      #
#            #
####6       6#
#4    45    5#
# ##3 K 3#####
#W           #
#######1    1#
#P           #
##############