##############
#     #      #
#     #   D  #
#  P  #      #
#     #      #
#1          1#
#            #
#     #      #
#  K  #   W  #
##############