##############
#     D     W#
#            #
####6       6#
#4    45    5#
####3 K 3#####
#2          2#
#######1    1#
#P           #
##############