T ############
 T    #      #
#  P  #   D  #
#     #      #
#     #      #
#1          1#
#            #
#     #      #
#  K  #   W  #
##############