##############
#  2    4    #
#1          K#
#   #        #
#   #   4    #
#   #P #######
#   #   3    #
#1  #        #
#D 2#   3   K#
##############