##############
#P  #       K#
#   #   W    #
#1          1#
##########   #
#2          2#
#   ##########
#3    K     3#
#           D#
##############
