##############
#P#D 1   K  1#
# #####  #####
# #  W   4 K4#
#  #         #
#   #   ######
#   3#       #
#     #    K #
#  23     2  #
##############
