###### T #####
#   P     K  #
#T    2   2 T#
#1          1#
### T K T 2  #
#         ##1#
#  T #### 3 ##
#W           #
#  K      3 D#
##############
